  # #  # ## ## ###  # #   #      #  #####  #     #   # #   #  # # ##      # #                       
     #  #  #   #  # #   #  # #         #  #   # ### ###  #  ###  #  # ##  # # # #  # # #    ## # #  
# # # # # # ##   # # # # #    # ## ####  #  ##   # #    #  # # #   ####  ###  # # ##     ##   # #  #
#  #   #     # ##     #    ###    ##   #  # #  ##   ## #  ## #   ## #  #  #  #   ##  # ##  # ##   # 
  # # # ## ##    # # # # #    # # #  ##  #  # #  ##      #    # # #  #  #  # # ##  #  ##  # #   ##  
 #           ## #   #   #  # #   #  #  #  # #  #   ## # # ## #      #  ###     #  ## #  #    ##  # #
  # # # ## # ## # #   ## #  # # ## #  # # #   #  ## # #       # # # # # # ## #  #      #  ##    #  #
#  #   #  #     #  # #     #         #     # #  ###  #  ## # ##  ##   #   # # #   # ## ##   ## #  # 
##  # ###  ## # # # #### #  # ## ## # ## #   ##  #  # #  ## #   #   ## # #  #   #  #  # # #   #  #  
# #  ###  #  #       #  #  ### #   #    # # #  #   ##  #     # #  ## # #  #   ## #  #     # #  # # #
    # # # # # ## # ## #  #  #    ## ## ##     # # #  #  # ###   ## # # # #  ###   ##  # #  ###      
# # # #     # # #   # # #  # ## ###  #   ## ##      #  ##    # # #     #  #     #    # #  # # # # ##
 #     #### #   ### #    #    #  #  #  #  #  # # # #  #   # #  #  # # ### # ## #  ##    #      # #  
  ## # #  # ## #    # ##  # # # ###  #  ##  #   ### # # ## # #  #  #   #  # # # ### ## #  # ## #   #
 # #  # #      # ##  #  # #  #  ### # #   #   ## #    #  #   # #  ### ## #    #       ### #   # # # 
    #   ## # #  ## #   #    # #  #  #  ##  # #    # #  #   #    #  #  #  ## #  ## #### ##  ##       
# # ## #  ###  #     ##  ###    ## #  # ##    ## # #  #  # # # #  ### # #    #           ## # ## # #
##     # # # #  ####   #    # #      #    ###       # ##  # #  # # ## #  # ##### ## # #####  #  # # 
#  # ##  # #   ##  # ##  # # #### ##  # # #   # ## ##    ##  ##  #    ##     #     ####  #  #  #  # 
 ##    #    ## # #   # #  #   # ## # ##  #  #### # #  # ##  #  #   ###   ## # ### ###  #  #   # #   
 #  # # # #    #  # #  # # ##          # # #  #   # # # # # ## # ##   ## # #    #  # #  # ## #   # #
   # ##  #  ##  #    #      # ## # # ##  #   #  # #    #  #  #    # ##       # #####   ##      # # #
 #      # # #  # ## # ## # # #  ###   ##  ## ##  #  # # # ##  # ##   ### ## #   #   # #  # ## # #   
 # # ###   # #            #   #  # # # # ###   #   # ## #    #     ##  # #   ##  # #    #  # #    ##
#   #  # ##    # # # # ##  # #  #    # #  #  ##  ### #    ##   # # #  #   # #  ##   # ## # #   # #  
## ###   # # #  #####  #  #  ##  # #    # ## # #      # ## # # # ## #  # # # #    ###  # # # #  # # 
#   ### #     ## # # ## # # #   # #  ###   # #   # ##       #####    #        # # #   #      ###    
  #  #   ## # #  # #        # #    # #  # #   # ##   # ####  # #  ##  # ## # # #    # # # # #   # ##
 # # ## #  # #  #   ## ### #  # # #   #    ## #   ## #    ##    # # ##    # ## # ### #   # #  ##  # 
 #        #   #   # # #    # #   # # # # ##     #   # # #   ####      # ##            # #    ## #   
# # # ### ###  ##  #  ## #  # # #  # # #   # # #  #   ##  # #   ### ##     # ## # # #     ###     # 
# ##  #      # # #  #   ###   # ## # #   ##   # #  # # ## #   ##       # ## #  ##  #  # #     #### #
     # #### ## # # ## #  # # #     #  # #  # #   #####   # ##  # # ## # # #  # #  # ##   # ##       
 # # #             #  # #      # # ## # # #   # #  #   ##    ## #    #  #  #    ##    # #  # # # # #
#   # # ## # ## # # #  # ## ##  # #   # #   #     # # #   ## #  ## #  #  #   # #   ####  #   #  ### 
 # #   #   # # #     #    ##   #  # #   # ## ## # #    ## # # #    #####  ##  # # #    ## ##  ## #  
  #### ## # #   # ## # ##   # ###  # # ##    # # #  # #     # # # #   #  #   ##     # #    # #     #
#  #     #   # ## #   #  ##    #  ## # #  # #  # ## # # # ##  #  #  ## #   ##   ## # # # #  #  ###  
  # # ##   #     # # #  # # ## # #   #  # ##  ##     #  #   #   # #  #   ## # ## ##       ### #   # 
# #  #  # #  ## #      #   ##  #  # # # #    #   # #  # # ##  ##  ##   #  #    #  # ## # #     # # #
   #  #  # ##     ## #  ## # # # ##   #   # # # # # #  #    # #  # # ## ##  ### #    ### # # ##  #  
# # #   #   # # #  #  #          #  ## # # #    #   # # # # # # #          #  #   # #   #   # # #  #
  #  # # ##  # #  # ##  #### # #  #  # # #   ##   ## #  #  #      ## # # # # ## ## # # #  ##      # 
#   #  # ###   # #  # ##   ##  # #  #      #   ###    # ## # ### #   ###  ##    #  # #   #### ###   
  #   #   #  #  # #      #   ##   # # ### # # ##   # #     # # #  # #   ###  ##   #    # ###     # #
#  ##   ##  ## ##  ## # #  # # ## # # # ##   #  # # # # ##      # ### ##    # # #   # # # # # ##  # 
 ## ## # ## #     #    ### #        #      #   #  #   #  ## # #  #     ## #    # ##  ##   #   # ##  
     #    ## ## #  ## # # #  # ####   ## ## ### #   #  #   # # #  # ##     # #     ##   #   #   #  #
# ##   ##       # #  #      ###     # # #     # # ## ##  # #    #  # # # # # # ## #  # # # ## #   # 
  ## #  ## ####  #  ## ## ## #  # #  #    ## #  #       #  # # ###      #  ##    #  #  # ##  # ##   
 #  # ##  #     # #   #  #    ######   ##### ## # # ###  ##   # #  ## #  ##  ## # #  #    # #    ## 
  # # # #  # ## # # ##  #  ## # # #  #    # #      #   #    # #  #  # # # ## # #   # # ###   # ##   
##    # ## # #    #    #  ##    #   #### #  ### ##   ## #### # # ###   #        # #        #     ## 
  # ##   #  # # ## # # # ## # # # #  #  #  #    ####                ##   ### ##     # ## #  # ## #  
 #   ###   #       # #  ##   #   #  #  # #  ## # #  # # ## # # # #### # #   #   # ##    # #  #  # # 
   #     ##  # # ##  # ## # # # #  #  #    # #     # # #  #  # ##     #   ## ## #   ###   ##  #    #
# #  # # # #  ##    # ##    # # ##   #  # ##   # #       ### #    ###  # #   # #  # # ####  #   # # 
##  # #     # #  ##      ##   #  # # # ####  ##   # ## #### #  #### ###    #   ###         ## #  #  
# # #   # #   ## ## # # #  ##  #    #   #  #   ## #  #   #  ##         ## ## #    # # # # ## #  # # 
     # #   # #  #  ## ##  #  # # #### ##  ## ##  # ##  ## #   ## # # ##   # # # # #  #  # #   # #   
 # ## #  ##  # # #   #   # # #  S.    # # #     #    # #    # ###  # # ##      # #  # ##   # # # # #
 # #   # ####     # #  # #     ##.# #       ## # # ####  # # # # # ##    # # #   ##    # #   # #    
  #  #  # #   # #    ##    # # #.. #  # # # # ##   # #  # ##      #   ## ### # #  ##### #  #     # #
 # ## # # # ## ### #   # # # # #.#  # ##  #      #     #     # # # ##   #   ##  #     #  #  ## ## # 
#          # #  # # ##    #  ## . # #   ## ## # # ## # # ### # # #    ##  # #  ### # ###   ##       
 # ##### # #  #        ### ## ##.# ## #     #  #     ##     ### # # #  # # # #  #  ## # ##   ## # ##
  #    #  # #  # ## # #         .    # # # # ## # ### # ## # #  #    #        # # #       ##  # #   
#  ### ##    #   #  # # # ## # #.###   ##        ## #    ##   #   # #  # ##### # #  ### ## # #### ##
##        ##   ## ###  # # # # #.   ##  ## ## ###     ##  # #   #  #  #            #   ##     #     
# ## ## ##   # #      ## #    ##.# #  ##   #      ## #  #    # ## ## #  ## # # # #   ##  ## #  # ## 
      ## ## #  # # # ##    # #... #  #   #  ## # # ##  #  # # #  #   # #    ###  ###    # ## ##   # 
 ##### #   # ## ## # # ## #  #.##   #  #  #   ##     #  ###     #  ##   ## # # #   # ##    #  # ## #
 #       ##        ##     ## #.# ### # # #  #   # ##  #    # # # # #  # #       ##  #  # #   # #    
  # ## #   # # # #  # # #   # .       ### #  # #    #   # #   #   #  ###  # ## ### #  #   # #    ## 
 # #  #  #   # # # #  #  # ###.# # ##  #    #   # ## # # ## # # #  ## # #  ## ###    # # #    # #   
#  ##   #  #  #  #  #  ##   # ..#    #  # #  ## #    #     ##  # #      # #    #  # ##   # # # # ## 
 #  # ##  #  #  #  #  #   ##  #..####  # ###   #  # #  # ##   #  # # ## # # ##  #  ##  #  #       # 
  #   # # # # #  ##  ## ##   # #.....##   # # ###  ###  #  # ## ## ##  #      # # #  # ##  # # # # #
# # ##     #    #   #     # #  # # #...##      # ####  #  # #         ### # ##   ### ## # #   #     
    #  # # # ## # #  # # #   #   # # #.# ## ##   # #  # #     # ## # # # #    # # #   # #### ### # #
# ### #   # #   # # #  ## # ### #   #..    #   #    #   # # # ## ## #    # # # #   # #    #  ##  #  
  #    # #    #  #   #  #    #   # # .# ##  # # # # # #    # #        ##  #  # # #   # ### ##   #  #
#  ## #   # #  # # ##  # # # ## #  ##.## ###    #  ##  # #     # ## ### ## ##   ### ## #     ## ##  
  #    ###   ##  #  # #     #   # #  ..     # #  #   # #  # ## ## #      #   # # ##      # ##     # 
##  ###    #  # #  #   # # #  ##   # #.######  ##  #  #  #   #    # ## #   # #      # ##  #  ## ##  
   #    ##  ##   #  # ###  # # ## ### .      #####  #  #  # # # ##   # # #  #  # # # # # # # # # ## 
 ##  ##   #  ## ## #   # # #    #  # #.# ## #  ##  #  # # ##     #### ##  ### ##  #  #  #  #       #
##  #   #  #  ##   ## #    # # #  #  #.#   ###   #  #   #   ## #      # # #     # ##  # ##   # # # #
   ## #  ##### ###  ## # # #  #  #  # ..##  ### # ## # #  #   #  ## #    # ## #  #  #    # ## #   # 
# #   # #  #       #     ####  #  #   #..### #        ### # #  #   ### #       #  # ### ##     # #  
#  # ## # # # ## ##  # #   #  #  # # # #..     ## ## # #   #  #  ## # # # # # # #          ## # #  #
  ##   #      #  #  # ## ##  ####    #  #.# # ###  # #  # # ## #      #    #  #   ### # ## ###  # # 
##   #  # # #  #  ###      #  #   # #  #.. ##  # ##    # #  #  # ##### # ##  #### # # #  #  # # #   
   # # # ##  #### #  ## ##  # ## #    # .#   #     # # #   #  ##        #   ###      # ## #   #   # 
 #  #  #    #  # #  #     #  # ##  # ###. # #  # #  ##   # ## # # # ## ## #  # # # #       ##   # # 
#  # ## ## # #   ##   #### ##     #   # .#   #  #  ##  #  #      #  #    # #    ##  # ####  # #  ## 
  #        #   #    #    #    # # ###  #.## # # # #  #  #   # # ## #  # #    # #   #  #   #  ## #  #
 #  # # ##  # #  ##  ## # # ##  #    # #.. #    #   ### # # # ##  ### #### # ##  #  #   #  # #    ##
 # #   #   ### ##   ##    #   ### ####  #.# # # ######   #  #    # # #  # ##   #  #  ##  # #  # #  #
# ## #  # # #    ##   ## # # #    #   # #.#  #      # # ###  # #       #    ##  # ##  # #   ##   #  
     ## # #   ##    # # #  ##  ##   ##  #. # # ## #   # ##  #   # ## #   # #  ##   ### #  # # # #  #
 ## #    #  # # # ##    ##    #   #   # #.## ## #  # #    #  # #    ##### #  #   #      # # #  # ## 
#    # ## #  #      # #   # #  # #  # ## ...    ##  # # # # #   ## # #      # ##  # ## #  #   #     
  ##  #     #  # ## ### #  # # #  # #   # #.# #   #    #   # # #   #   ## ##  # ##    # ##  #   ### 
 #  ## ###### #   ##     # #   ### # # ## #..### #  #### #    #  #   ##     #   # ## #    ### #    #
  #  #        # ##   # ##   ##       #   # #..# # # #   ## # # #  # #  # ##   ### # #  ####  #  # # 
 ## # # ## # # # ## #    # #   # # # # #    #...  #   #   #     # #  #     ##        #      # ## #  
 #     ##   #        # ## #  # #  #  #  # # # #.# # #  # # # # #  # #  # #   # # # #   ## #      # #
#  # #    # # ## ## #      ## ## # # # #  #  ##. ## # #     #  # #  # #   ###   ##  ## #   # ## ## #
 ###### #  #  #  ###  ## ###        ##  #### #..#    # # # # # #  ##  ## ##   #   ## #  # #   #     
   # #   ##  # #  # # ##    ### # #   #   #  #.## ##    #    # ## # #  # #  ##  #     ###  # ## ## #
##     # # # #   #      # ##     # ## ###### #.  #  # # ## ###  ##    # ###  # # # ##    ##    ##   
  ####  ##    ##  ### #  # # ###    #     #  #.#   ##  # #    #   # #    #  #    #   ## #   ##   # #
#     # #  # # # ##   # #    #   ##  # # #  #..# # # #    #### # #  # # # #  # ##  # #   # ## # #   
# # #  #  ## #   #  # #  # #  ##  # #  # ### .#  #    # #      ## #  #  # ##  #  #  # ##  #   # # # 
  #  #   #    # # # #  #  #  #  #  ### #   ##. #  # #  ## # ##    # ### #    #  # #     # ## #   #  
 #  # ###### #  #   ##  #  # ## # # # ### # #.# #  #  #   #   # ##   # # ## ## ##   ## # #    # #  #
  # #    # ## ##  #  # # ##   # #      # #   .  # #  # ##  # ##   # ## #  # #     # ##     # ## # # 
 #  ## #         #  ## # # ## #   ## #    ###.## # # #   #  #  ###       #   # # ##   # # #  #   #  
  #  #  ## ## ## # #        ##  #  #  ## # ...     #   #  #   #   # ## #  ## #  #   #  #  ##  # # # 
 #### ##   #  ##  ## # # # #   #  # # ### #.### ###  # # # # #  # #  #  ##   # #  # # ###   # # #   
  #   # ## # #   #  # #  ##### ##   #  #  ..  ##   #  #    ##  # #  # # #  ##   # #  # #  #  #   ## 
 # # #      #  #  #    #   #  # # #  ##  #.##    ##  #  # #   #  ##    # ## ## #   # #   #  #  #    
##   ## # #  ## #   ## # #   #     ###  # .#  # ## # # #    ## #  # # #   #    # # #  ##  # # # # # 
  ##    # # ##   # #  #   # #  # #    #  #. #  #      ## ##    # # # #  ## ## #   ###   #  #    # # 
#    ## #  #   #    #   # #  # #  # # # # .# ## # # #   #   ###       #     # ## # #  #  #  # # # # 
 # #   #  #  ## ## #  #  #  # # ### #### #.....  ### # #  #     ## ##   ## ###     ##  # # #  # #  #
  #  ### # ##      # #  # # #         #    # #.#  #  #  # ## # # #  # #   # # ## ##   #   # # # # # 
 # # #   #    # ##  ###    #  # # # # # # ## #.##   # # ##   #    # #  # #  #      ## # ##     #    
    #  ### # # #   # # ###  # # # # #  #    # .. # #   #  # #  ## ##  ##   ### # #   #    # # # # # 
## #  #     #    # #   #  # # #  ##  # ## #  ##.# ## ##  #   # #    ##  ## ##  #  ##  # # # #   ### 
    ## # # #  ###    #   # # #  #   # #    ##  .  #     #  # # ## #    #     #  # # ####  ### #    #
# #     ### ##    # # ##      # # ##   ## #   #.#   # #  # # #  # # # # # ### # #     #  #     # ###
 #  # #  #     # ##     ## # ## # #  ##    # # . # # # ##  # ##  ## ##  ##    ### # #  ##  ## ##   #
   ### #   ## #  #  # # #   #   #  #    # #  ##.# ## #  ## #   # #     # # ##    # #  # ####    ##  
## ##    #  # # # #  #  # #  # # #  # # #  ## #.       #  #  #  #  # #       # #    ##      # #   # 
 ##   ## # #   #  # ### # # #     #  #   ##    .## # #   # #  # ##  #  # # ## #  # #  ## # ##  ## # 
    # #   # # # #    #  #  #  # ## ##  # # ## #.. # ## #    #  #  # ### #      ## ## # # ##   ## # #
 # # # ###      ## #  ##  # # # #   ## ##      #.## # ### #  #   #      # ## #             ##       
#  #      # # ## # # #  # # # #  ##  #   # ## # ......## #### ### # ###  #  #  ####### # ##  # # # #
# ## # # # #     ##   #      #  ## #   #  # #  ## # #.....# # # # #   # # #  #        #     #   #   
    ###      # #  # # # ## # ####    # # ##   #    # # ##.         # ## # # #  # # # # ## #  # #  # 
 # ### #####  #  #   ####   #    # #  #    # # ## ##    #.# # # ##  #     #   #   #    #   #  #  #  
# # #        # #  # ###  # ### # ##  #  # ##     #   # # ..# # #  #  # # ## #  # ### ## #### # #  # 
      # # # #    #   # # # ## #     ## ## #  ###  # ###  #.......# ##  # # #  #   #         ##  # # 
# ## # # #  # ##  ##   #  #     # #   #    #    # #  #  ## ## ##...  # #    # # #  # # # # #   # # #
   #     ##  #   # # #   ## # #  #  #  ## #  # ## # # #   #   #  #.## ## # #  # ### # #   #  ##     
# #  # ##  # # #    #  #   # ## # #  #  # ## # #  #   # #  ##  # #.     #   # #        # # # #  # ##
#  #  # # #  ##  # #  #  # #      # #  #    #   # ## ##  # # # # #.# # # # #   # ## ## #       #    
  #  #     ## # #   #  #  # # # ##   ### # ### # # # #  #    #  # . #     #### #   # # # ## # #  ## 
# # # # ##       ##  #  # # ##  #  #    ##  #  # # #  #  # ##  # #.# ## #  #  ### ## #  #    # ##  #
 #     ### # # #  # # ###    # #  #  ##   ## #      # # #   # ## ..    # #  # ### #   ## # ##     # 
   # ## # #  #  ##    #   ##  #  # #   # ###   # # # #  ## # #  #.## #   ##    #    #     #   # #   
##  #       #  #  # ##  # #  # # #   #  # # # #  #   # #      #...#   ##   # # # ## ## ## ## #  # # 
   # # ## #  #   #   # #   # # ## # # #   #    #  # #   ## # # .#  # #  # ## # #  #   # #     ####  
 #   ##   # ### # # #   ##  #         # # # # #  # # ## #   # #..#  ###   # # # ##  # #   # #   ### 
  # #   #  # # #   # # #   #  # # # ##   ###   #      ## # #   #.# # # ##       #  # ### #   # # # #
 # # # # # #   ###   #  ##  ##   #   ## ###  ##  ## ##   #  # # ..#     # # # #  #   ##  ## ##     #
#  #  #      ##   ##   ## # # # ### #  # # #  ## ##    #### #   #..# ## ###  #  # ##   #  #   ## #  
##   # # # #  # ##   #    ##    ##    #     ##     # #   # ## #  #..#      #  #     # #  ## #   #  #
# ## #   #  ##     #  # ##   # #   ##  ## ## # # # #  ##     # #  #..## #####  # # #  ####  ## ###  
       #  ###  # ##  # ## # ## # #  ##        #  ##  # # # ##    ###...    # # #  # #     #   # # ##
 # # ### #    #    #       #   # ##  # ## # #  #   # # ##    # #  # ##.## #  # # #    # # ###     # 
 ##  #    # # # ###  # # ##  #  #   #    #   # ## #      # #  #  #    .##   # ##  ## #  #    ## #   
  ##  ## #   #  # # #   ##  #  #  #  # # # ####    ## ###   #  #  ## #.  ##     #  #  #  ## #  #  # 
 #  ##    # ## #    ## #   # # ## # #   #    ## ##   #  # # # # # # ##.#   # ##  ##  #  #  ###   ###
## #  ## ###    # #   # ###      ##  # ## # #  #   #   ##  # ##  #    ..###   ##   #  #   ### ##  # 
    #     # # # ##  ##  #   # # #   #    #   #   #  # #   ##   #   ## #... # # # # # ## ####   ###  
## #  # #    #    #   # ## #   ### # # #  # #  #  # # # #    # ## # #  ##.#    #  #  #    # # #   # 
     ###  ## ## ##  #     #  #  #     ###  # # # ###   #  # # #  #    #  ..# #  #### # ## #    ##   
 # #  # #   # # # #  # # ####  # # # # #  #  # ## ### # # #    #   ##  # #. # ##  # # #  #  ##    # 
  ## #    ##   ##   #  # ## ## #   #    #  #       ##    #  # #  # #  ## #.#  #  #     # # # # ##  #
##   ## #    #   # ###  #       ##  # #  # # ## ###   # # # # ## #  #   # ...# # # ## ##      ####  
   #   #  ## # ##   #  # # ## # #  # #  # #  #    ### ##    #  # # #  #  # #......   #   ##### #### 
 #  # #  #   #  ## # # #    # #  #    ###   # # ##      # #  # ## #  #  ###  ## #.## # ##       ## #
## #   #  ##  #   #  #  # #  ## ### ##    #   #   # ## # # # #  #   # #  ## #   #.. #     ### #    #
    # #  # # #  #   #  # #  #    #    # #  # #  ### #       #  # # #  # #   # #  #.#  # #    ## # # 
 # #   #    ### # # # #  ##  # #  # # ##  ## ##    ## # # #  ##      # #  #  #  # .. #  # ##   #    
#  # # ## #  #  #  #  ##  ## #  # # #  ##   # ## #   #   #  #  # # #    # # # #  ##.# # #   # ## ## 
  ### #   # # # # ###    #    #  #   ##   # #     ## # #  # # # ##  # #  #  #   # #....# ###  #  ## 
 # #   # # #    #  #  # #  # #  ### #   #  # ## # ## # # #        ## #  #  #  #   ## #..    #  #   #
     ##     # ##  # #  #  ### # ##  # # ##    # #   #  # # # ####     #  ## ### ##    #.#### # ## ##
 # # # # # ##   #    # # # #      #  #   # ##  #  #  # # # #     # # #  #        # # # ..     #    #
##  #  # #   ### # #  #     # # #  # # ##   # # # ##  #   #  # #  ##  ##  # # # #   # ##.# ##  ###  
   ## #   # #       # ## ## #  #  #   #   #  #  #   ## # ###  # #   #   ##   #  ## #    .# # ##   # 
## #    #  # ## ## #   # #   # # # # #  #  #  #   ##      #  #  # #  ### ## # #   #  # #..#  ### # #
    # # # #    #    # # #  #  #     # # # #  #  # # # # #  #   #  ## #        # #  ##   #...# #     
 # #  # #  # ## # ##  # ## # ### # #   #  # # # #    ## # # # #  # # # # # # ###  ### ##  #.# ## # #
#  ###   #      ## # #      ###   ####   #     # # ##  #  #    #    ###  # #  ###  #  # # #....   # 
 #    # ## # ##  #   ## # #  # # # #   #  ## # #      #  # # #  # #  # ##   ## #  # #   # # ##.##   
   # ##   #    ## # #    ## #      ## #  #    #  # ##  ##  # # ### #    # #  #   #    ##   # #.. # #
 #  #   ## # #  #    ## #    # # ## # ##  ## ## #    #   #    # #  # # #   # ## # # #  ## #   #.#  #
# #  ##    # # # # #  #  # #  #      #   #     # # # # #  # #     #  # # # #   #     #  #   ## . #  
   #   # # # # #    #  #  #  # # ####  # # # #   #  ## ## #  # ##  # ##   #  ##  # ### ## #   #.# ##
 #   # ###  #  # # # #  ## # # #     ##   #   # #  #    #  # #   #  #  ## # ##  ## #     # ### .....
# # #     #  ##  #    #     #    # ##   #  # ###  ### #  #  #  # ##   #  #  #  #    ## # #    # # #.
     # # #  # ### # # ## ###  # ##  # # # #   # # ## ### # #  ##  # #   #  # #  # # #  #   # ## ## .
# # #  #  #     #    # #   # #  # # # #  #  # #       #   # # #  # #  #  ##    ## #  # ## # #     #.
 #   #  #  ### # ### # # ## # # # ##  # # # #  ## ## ## #   #  ##  # ### ### # #   ##   #    ### ##E
   ##  ### #   #        #           # #    #  #   #    ### ###   #    #   #  #  # #### #  ## #     #
