width=10
height=5

##########
#S       #
# # #### #
#   #  #E#
##########