#  # #   # #  #  #   #    #  ### # ## #  #  #   # #  # # # # #  #  ##  # # #                        
 ## # # # # # # ## # #  # #  # #   # # # ##  ###  #  #  #     #   #  ##   #   # #    #   #   #      
  #    ##   ##   #     ## ## #  # ## #      ##  #  #  #  # # ## ## #   ##   ### # # # ## # ## # ### 
 #### #  # #  # ### ## #       #     # # ##   # # #  #  ###      #  # #  # #     #            #    #
  #    #   # ##  # ###  # ## ## ## #  # #   ##  #  # # # # # ###  #   # #  ## # # # #### # # ## ### 
# # # # ## # #  #   #  #  ## #  # # #    ## # #   ## # #     #  #### ##   #  #    ##     #  #     # 
   ## # #     #  # # #  ##     ##    # # #     # ##     ####   #  #  #  ##  #  # #  ## # # # ## ##  
##    #  # # #  #  #   #  # # ##  ## # ## # ## # # ### ##  ## #  # #   ### # ##   # # # #       ## #
 # # ###  #    #  #  ##  # #    #   #      ##  #   #     #  #  # #  # # #    # # ##   #   ## ##     
   #  # #  # #  # ##   # #  # # # ## # # #   #   ## # # ## #  #   # # #  ## #  # #  ## ##   #   # ##
 ## # # # # # # #    ##   #    #      #  ## # # #    ##    ##  # #      ##    #    #      ## # # ## 
#         # # # # ##    ## # ## # ## #  #        ## ##  ##  # #  ### ###   ##   ## ### ##     ## #  
 # # ## #     #  #  ###      #   #   ## ## # ## #     ###  #    #       ## #  ##  #     # ## #   # #
    #  # ## # # # #    # # ## # #  #   # # # #   ## ##   #  # ####### ##  # #    # # ##  ###  # #   
# #  #    ##  # #  ## #  #  #    # # ##  ## ## #  # # ## ##     #   #   #     ###  # ## # # ##   # #
  ### # #   #     #   ##  ## # #  #  #  #     # # #   #   ### #  ##  # ### ##   # #    ## #  ### #  
 #     #  #   ## #  #  ##      # # #  #  ## ##  #   #### #  ## #  ##    #   ## ##   # ##    #    # #
 # ## #  #  ##   # # #   # ## # #  # #  # #  ##   ##  #    # #   #  ## #  #  # #  ## #  # #  ###    
# ##    # # #  #  #   # ##   #    #    #    #   ## # ### ##   ##  # #   #  ## ###    ##    ##  # # #
     ###   # # # ### #     #  # #  # # ## # # #  #    #  # # #  # #  ## # # #  # # #    # #   # #   
# #### ## #   #  ##    # # ##  #  ###   ##  #### # # # # # #  #   ##  # # #   ##    # #### # #    # 
##      #   ## #    # # ###   #  # ## #    #  #   #  # # #  #  ##  ##       ##   # #    #     ## #  
#  # # # # ##    # #  # ## # #  ##   #####   # # # # #    #  # #  # # # #### # #  # # # #### #### # 
 #  #         # ## # #     #  # #  ## #  ## #        # ##  #   ##    #     #  # # #  # #   # ###    
  ## ## # # # ##  # # ## #  #    # #   #     # ## ##  ##  # # #  # #   # ##  #  #   #  ## #   #  # #
# #  #   #   #  #        # #  # #   ##  # ##    ##   #   #     #  # # # #   ###   ## #     # # ##   
    # ##  # ###  # # # #  # ##    ##  #     # ## ###  ##  # ### # #   #  ##  ### # #   ## #      # #
# #     ##   # # #  # # #     # # # # ## # # #       ##  #  #   #  ##   # # # #    # ##    # ###    
 #  ###    # #    # #    ## # # #       # #    ### # # # ##  ##  #  # # # # # # ###  # # ####   ## #
 # #    ## ## ## # # ###  # ##   ## # ##  ## ##  # #        #  #  # ##        #    #    #  #  # #   
  # # #  ##             # #  ## # ##  #  #  ### # #  # ## #  #   #    # ## # #  # ## # #  # ##   # #
# #  #  #  ## # #### # #  # #  ##   #   #  # #      # #  # # # # # # ## # # # #  #    #  #    # #   
  # # ## #     #      # # # ## #  ## ## ##   #### # #  #     #  # #       #   # #  ## ##  ## #  # # 
#   # #    # #  # # # # #    #   # # #   # #     # #  #  # # # #  # ## ##  ##    # #     #     #   #
  #    # #  # ##   #     ## ####   # # #  #  # ##   #   ###  #  #  #     ##  ## # #  ## # ####  ##  
 ### #  # # #   ##  # ##     # ## #   # # # #  # # # ### # # ## # ### # ### #      ##   # #    ### #
# # ###    # ## # ## #   ###       # #    ## #             #       #   # #  ### # #  ##    # #  #   
     # # ##  #    #  # ### ### # #   ## #  #   # ## ## # #  ## # ## # #   #   #  # # #  ##  #  #  # 
# # #     ##   ##   # #        # # #  # # ### ## #  # #  ##   #   # #  # # # #  #  #  #####  #   # #
 #    ## #   #  # ##    ## ## ## ### #### ##    ## ##  ##  # ### #  # #  #   ##   ###   ### # ## #  
   ## #  ## # ##     ###  # ##  #     #     # # # ##  #   #   ## # #    # # # # ## #  #  #  #  # # #
#### # #   #     # ##   #     # # ## # ## #    ##    ## #   #      ## ##    # #  #  #  ##  ## #     
       # ## # ###  #  # ## ##    #      # ## # # # #   ## # # # ##      ## ##   # # # #  # #   # ###
# # ##    #  ##  ## # #   #### ## ## ##  #  # #   # # ## ## ###   ## # # #    ##      ##    # #     
   #   # #  #  #     # # # ### #     #  #  #  # # # #    # #    ## # # #   # #  ## # #  # ##  # # # 
 ##  # #  #  # # ## #       #    # # # #  # #  ##    # #   # ## #   #   # ### #     #  #    #  #   #
 # #  ###   #   ##    #### # ## ###   #  #   #    # # #  #  #  # ##   ##   #  ## ## ##  ## # #   ## 
#  # # #  ##  # # # ##           # # # # ## # ## #    # ###  #      #    ##  #   # #  # #    ###  # 
  # #   #  # # #  ## # # # # # ##             # # # #  # # # # # # #  ## #  # # ##  #    # ##  # #  
#     #   #     #  #  # # #  # # # # # # # ##   # # # #    #  #   #  #     #       # ## #   # #    #
  ## # ##  # # #  ## #      ## #    #   # ## ##      # ### # #  #  # ### ## # # # #  #  # ##  # # # 
 #  #  # #    # #     ## # #   ## #### #        ## #           #  # #          # #  # #    ## #  #  
#  # #    ## ##  ## #    #### #  #  #  ## # # # # #  # # # # #  ##  ### # # # #  # #  ## #  # # ## #
  #   # ## #    ###  ## #  # #  # # ###   ##   #   #  #  #  # # # #     ## ##   #   #  ##  #    #   
#  ## #  # ## #  # ##  # #    # #     # ##   # # #   #  ### #  #    ## # # #  ## # #  #  #   # ### #
  # #  # #   #  #  ###   ## #   ## ## ##  # # # #  ##  # ###  # # ##   #   ##  # #  # # #  #### #   
 #   #   # ## #   # ####   ## #   ###   #  #  #  #   ##   #  #   #  ### ##    ## # #  # # ## #   # #
 ## ####        ##   #   #   # # ###  ##  #  # # # #  # #   #### # ## #  ####       # #       ## #  
     #  # # # # # # # # #  ##     # #   #  #      # ## #  #  #     #  ##    ## ## ##   # ### # # # #
### # #  # # #      #  # #   ####   ## #  # # ###        # #  # ###  # # ##  ##    ## ##    #      #
        #  # # ## #   #   # #   # #     #    #   # # # ##   # #    # #  #  #  # # #   #  # # # # #  
 # ## #  #    # ##  #  ##    # ### ## ##  # ## #  ### # # ##   # ##  # #  # # ##   # ### ##   #   # 
#    ###  # #      # # # ## ##  #       # # # # #  #      # ##   # #   ##       # #   #   # ##  # # 
# ### #  #  ## # #    #   # #  # # ## #    #    # # ## ##   ### ##  ##  ### # # #  # #  #   #  ### #
 #      #  # #  #  ### ##   ##    #### # #  # #     # ##  #  #     ### #   # #    #  # #  ####  #  #
  # # # # #  # # # #   # ##   ## ####   #  # ### ###  # ## # #### # #  ## #   # # ##  # # # #  # #  
# #  #   #  ###    ### #   # ##   ## # # #    #     #           # #  #  #   #  #    # # #     #    #
#  ## ##   # # # #   #  # #     #         ## ## ####  # # ## ##   ##   # # # #  # ##  #   ####  ####
 # #     #      # # ## #    ## # # # ## #           ## ###  #  ##   # #   #   #   # #   # #    #   #
    ## #  # # #     #   # # #  #  ###  ### # # # # #    #  #  # ### #  # # ## # # # # #### # #  ##  
 # ### ###  #  # ## ## # ### ##  # #  # #   # #   #  # ## # #         #    #   #        #   #  # ## 
## ## #  # #  ### #       #  # # #  # #  # #  ## # ##  #  #  ### # # #####  # ## ## # #  # # #    # 
        # # ## ##  ## # # # #    # #   # ####      # # ## ## #  #  ## #    ## # # ##   # # #  ## ## 
### # ##          #  # #    ## #     ##    # ## # #        # # #  # #  ###         ## # #    #      
    #   # ## ## #  # #   ##   ######  # # #      # ## # # #     # # ##     # # # #  # #   # ## ### #
## # # # #   # #  #  # ##  # # #    #    # # # #     # ##   # #   #   #####  ## # #     #  #      # 
 ### # #  # #   # ## ## ##      ## # # #    #   ## # # # # ### ## # ##      # # # ## ##  ## ## ## # 
         ###  #           ## # ##  #  # # ## # #    #     # #   # #   # ### #   #   ### #        #  
 ## ## #  #  # ## # # ### # ##   #  # #   #   # # #   # # #  ##     ####   # # # # # #    # # ### # 
 # #  ## # ##   #  # #  # #    # # #   ##   ##  ## ### #    #  # # #  # # #  #        ## # # #  #   
#    #        #   #   #    # ###    ## ####    #   # #  # #  #  #  ##     ##  #### ##    #    # # ##
  # #### # # # ### # # # #  #   ## #    # # ##   ##  ##  #  #  # #   ## #   #     #   # # ## #  #   
 #   #  # # ##          # #  ##     ## #  #  ###    # # ###  # #   # # ## #  ### # ## # #      ## ##
# ## # #       # # # ##    #   # # # #   ####   # # # #  #  ## # #  #    # #   #   # ##   ## # #    
   # #   ## # # ## # # # # ## # #     ##  #   #   #     # # #  # ##  # #    # # ##      ## #  #  # #
 #     # # ## #     #    #        # #    # # # # # # ##       # #  #  # # # #   # ## ##  #  ## #  ##
# ##### #      # # # ## #  # ## # #  # #   #    #    #  ## # #  ##  #    #  # # #   #   ## # #   # #
          # # # # ## # # #  #  #   ## # # ## # ## # # #  # # ##    ## # # #    # ## # #        ##   
 # # ## # ## #    #    # # # #   ## #       #  # # #    # #    ## #  ## #   ##       # # ### ## ## #
#  ##    #    # #  ###    ##  # ##  ## # # # ##     ## #    ##      #   # ## # ## # #S.    #        
  #   # # ## # # # # # # #  #  #  #   # #  #   # # #  #### ## # ## # ## ## # ##    # #.# # # # # ###
## # #  #      #     # #   # #  # ## #   #   #  #   #  #  #     ## # #   #     ## #....## # # # #   
   # # ### # #  ## #  # # ##   #       # # # # # ## # # #  ## ##      # # ### #.....##    #   #   ##
 #    # #  ## #    ## #     # # # # # #     # #   # # # ## # # ## # #     # # #.# #  # ## ## #  #   
## # ##  ##   # # #     ### # #   # ##  # #    # #           #  ## # # ##      .#  #  ##       # # #
  # #   # ### #  #  ## #        ##   # ###  ## #   ## # # ##  #          # # ##.## # #   # # #    # 
# # # #         #  #  # # # # ## # ## # #  #     # ###   ## #   # # ## ##   #...  #   ##  ###  # ## 
      # #### ## # # # # ##  ##    #     ###  # #  # # ###    # # #    #  # # .# # # # ## # #  # ##  
 ## #  #     ##  #  #    ###  # #   # #     # #  ##      # # ##    # ###   ##. ## # ##      # # #  #
## ###  ## ##  ## # # # #  ## # # #  # # ##   # #   # # # #     ## #  # # # ..#   #  # # # #      ##
    # ##   # # #    ##    #     ##  ##    ### #  # ###  #  # ##   #  #   # #.## #  #  #   #  ## # ##
 ##      # #    # #    ## ## # #  ###  # #   #  ### # # ## ##   #  #  ##    .  #  #  # # ## ### ## #
 ### ## # # # #  # # ##      #  #     # #  #  ####            #  #  ## # # #.##  # # #     # #      
# # # # #      #       ## ##  ## # # ## ### # # # # # ## # # #  ####      # .###    # # ## # ## # ##
  #    # # ## ### ## # # #   #   # # #            # # # ## #  #  #  # ## ###..#  # #     #    # #   
#  ###   ##    # ###  #    #  ##   #  # # # # # #   ###     ## #  # ##    # #. # #  ## # # ##  # # #
 # #  # #   ## #  # # # # #  ##  # # #  #### #   # #   ## # #    #     # #  ..#  # #    #   # #     
     #    ##  ### #   # ##  #   # ##  ##  #   # ##  ##     #  # # # # #  # #.###  # ### # # # ## # #
 # # # # #  #  #   ## #  ### # #     ####   #   #  #  ## ## ##  #   # ###  #.##  ## #    # # # ## ##
  ##  # # #   # ##    # #       # # ####  ##  ## ## #    ##  # # # #    # # .. #    # ##           #
##   ## #  ##      ## # ### ## # ##  ## #  # #      ## ##   # ## ## # ## # ##.#  # ## #  # #### # # 
   #    ##    # ## #  ##  ###    #  #     #  ## # #     ###           ## #....# #  #  # #      # #  
###  ##    # #  #  ##  ##     # ### ## # # ##  #  ## # #    # ## # # #  ...# #   # ##  # # # #    # 
  # #   ## # ###  #   #   # # #  ###    ##    ###   #   # # # #   #  ###.# #### #    #   ##   # ##  
#  # ##  # ##    # ### # ###  # # # # ##   ##  #  ## # #   #  # # # #   .#   #   # ##  ##  # #     #
  ##    ### ## ##      #  # #  #       # # # # # #      # # #  #  #### #. # # # #   # #  # # # # ## 
#    ##  #    # # # ##   #   # # ## # #   #       # ## #  #   # #   # # .#    # ## #  ##    #  #    
 # ##   # ## #     # # # # #    #  #   # #  # ## #    #  #  #   ## ## ##. # #  #   ##  # ##   #  # #
     ## #      ## #   # # #  ###  # # ### ####    # #### # #  #   #     .#   # # ##   #   ## #  #   
## #  # ## # #  # # #       #    #  #  #    #  # #    #  # ##  ### # # #. # #  # ## #  # #    ##  # 
    #  # #  #  #  #  # ## #  # # # # ##  ##  ##   # # # # #   #    #  #..#   #  #   # # #  ## #  ## 
 # ## #    ###  #  ##  # # #  ## #      #  # ## #  ### ## ## # ###  # #.# # # #  ##  #    #    # #  
##   #  # # # ##  #  ##     ##     # ## ##       #  ##       #     # #..  # #   ### #  # ### # #  # 
   #  ##  #   # ##  #  # # #   # # ##  #   # ## ## #  ### ## ## ## ....# #  # #  #  ## #  # #  # #  
 #  #   ## ## #   # # # #    # #  # ##   # # #    # #     #   # # #.## #  ## ## #  #    ##    #   # 
## #  ##        #        # # ##  #     ## # #  ##   ## # # # #  #...#   #  #     #  ## # # ##  # ## 
    # # ## ## # # ## # #   ##   # # # #       ##  ## ##  # ##  #..#  # #  #  # #  #  # #     # ##   
 # # #       ## #  # #  # #   #    ###  # # #   #  #  # #     #..#  #   #  # ##  #  # ## # ####   # 
##   # # ## ##  # ### ## #  # # ##  # # # #  # #  # #  # ## ##..# # ## #  #    #  #     #    #  # # 
   ## ## ## #  #   #       #  #  # #   # ## #   # #  # ....#...#   #   # # # #  #  # # #  # ## #  # 
## #       #  #  ## # # # ### # # # ## #     # ## ##  #.##...#  ##   ##    #  #  # # # # #  # #  #  
   # ## # ### ## #  #  #   #  # #   #    ## ###  #   # .#  # # #   #  ## #  ##  #  # #  # ##    ## #
# # ##  #  #    #  #  # # #  ##  ##  # ##    #  # # # #. #  #  # ## #  #  #  ##  # # ## #    # #    
 #     #  #  ## # # # #    #   ### #    # # # #       ..#  ## #  #    # #  #  ##  #    # # ## ## # #
   ## ###  ### #     ### # # ##     # # ##  #  # ## ##.#  #    # # # #    # #  # #  # #   #      #  
# #    ## ##     # #  # # #   ### #    #  ##  #    #  ..# # # # #  # # # ## # # # # #  # ## # # ## #
  # # #     ## #  # #       ##   # # ##  #  # ## # # ##. #  #    # #  #     #   #   # ## # # #  #   
 #  #  # # #  #  ##  # ## #  # # #  # # # #      ## #...## #  ##  #  # # # ### ## #  #         # # #
 ### # # #   # #   #  # # # ###  ##         #####    .#   # # # ## #   # ## # #  # # # # # # # #    
#      ##  ##   ### # #    # # #    ## ######     ###.# ##    #      ##        #    # #  ##   ### # 
  # # #  # # # ##       # #      ## # #       ## # ... ##  # #  ## #  # # ####   # #    #   #  ## ##
 #   # # ##       ## ###   # # ##     ## # # ## # #.# #   ##  # #   # ##      ### # # ##  ##  #     
 # ##       # ####  #    # # # #  # ##   #  #     .. #  # #  # # # #   # ## #     #   # ## # #  # # 
 #   # ### ###   ## ### ##### ####    # # # # # ##.#  #  #  ##   #  # #   # ### #  # #      ## #  # 
 # ####     #  #         # #   # # # #  #  ###  #.. #  ## # #  #  ##   # #     # # #  # # #     #  #
 #   # # # #  #  # ## # #   ## #  # # #  #  # ##..#  #  #    ## #    #  # # # #     ####  # # ## #  
 ## #  # # ##  # #  #  ### #   # ## #  #  # #....#  ### # ##  #   # # ##     #  # # # # # # #     ##
#  ## # # #   #   ## ## #   ##        # ## ...##  #  #   ##  #####      # # # # #  #       #  # #   
 #      #   # # ##       ## #  # # ##   # #.# #  ## # # #  ## #  ## # #  ##   ## ## # # # # # # ####
   ####   # #  #  # ## #    ### # # ## #....#  #   #     #      #   ## ##   ## #  #    # #    #     
# #   # ##  # #  # #  # # #           ...# #  #  #### # # # # #  ##  #    #      # ## #   # # # ####
## ##   #  ###  #    #   ## #### ## ##.# # # # #   # # #  ## # #    #  # # # # #    # # # ####      
#   # # # # #  # ###   #    #   #   # . #   #    #   # ##      # ##  # #   # #  # ##  # #   # # # # 
 # ### ###    #      ## # ### #   # ##.#  ##  ##  # #   # ## #   #  ##  ## #  #  #  ## # ## # # ## #
    ##  # # #  # # # #    #  #  # ## ..##   #  # #  # #  #  #  #  # #  #   # # ## #      #          
 # #  # #  # #   # #  # #  # ## ##  #.# ## ## # #  #   #   # #  #  ## # ## #      # ## #   ## # # # 
## ##     ##   #  # ## # ##      # #..    #   #   ### #### #   # # #      #  ## # # #  # # #  # #  #
     # ##    # # #          # # # ...## # # #  # ###   #     # #   ## ## #  #    #   # #  #  #   #  
# # #  # ## ## ## ### # # #  # # #.#   #  #  #  # #  ## # # #   # #     # #  ## # # #  # # #  ## # #
  ## ##     # # # #    ## # #  #...# #### # # #   # #    #  # # # ## ##    #  #   #  ## ##   #    # 
#     #### #        # #    ## #..# #   #  # #   #  # ### # #  #  #    # ###  ## #  ##      # # ##   
  # #      # # # # # #  # ##  ..##  # ### #  # # ##        # # #  # #  ## ## #  # #### ## ## # ## # 
 # #  ## # ###  #    ##  #   #.#   #  ####  # #     # # ## # #   #   #     #  #  # ##    #   ##    #
   # #    #    # # #  ## # # #.# #  #  ## #    # # #####    # ## ###  ## #  # # ##   # ## # #   # # 
# #  ## # ## #    ## #  # # #.. #  #  #   ## #  ##### ## # ##  ##    ### # # #     # # #   ### #    
##  #    #    # # # # # #  ...#  ## # ###  ## ## # #    #     # # ## ## ###   # # ## ##  #  #   ## #
# #  # # # ## # #   #     #.# # #        #          ###   # #   ##      ### ##  # # #  #  #   ##    
    #  # #  ## ## ####### #.#  ### # # # ## # # # #     #  ## #   # # #  #     #    # # ## # #  ### 
 # # # # # #      # #     #.# # #### # ##  ##  #  # # #  # #   # #  #  ##  # #  # # #          #    
  #     ###  ####    ## # #.#    #   ##  #    # #  #   # # ## #  # #  #  #  #  ## #  ## # ## ## # # 
## ### # #  #     ## # # # .# # # ##   #  ## ##   #  #  #    # #  # #  #   #  #    #  ##  #      # #
 #     #   #  # #   #     #.# # #    # ##      # ### ##  # # #   #  # # # ## ## # #  #   #  ## #    
  # ###  # ## ##  ##  # # #.# ##  ## ##   ## ## #####   # #  ###  #     # #    #   ## # # #  # # # #
# ##  ####  #   # #  ### ...#   # #    # #       #### #   ###    # ## ##   # # ## #     # # #   ##  
   ##      #  ## #  # # #.# # #  # # # ##  # ## # ## # ##    # #   #   # #  # #   # # ##     ##   ##
 #    # # ### #    ##    .# ##  #    ##  # #   #          # # #  #  # # #  #   ##  #### ### #   #   
#  ##  #   # # ####   ###.#  ###  ##  # # #  ##  ###### # # #   ## #     # # # #  # #        ## ####
  ## ##  #   #      ##  .. #    ##   #      #   #       ## ## #   #  # # #   #  # #   ## # #  #     
 ##     ### # # ### #  #.#  # # #  ## # ###  # # # ## #    #  # # ## #  #  #  # ##  # ### #  #  ## #
   ## # ### #  #    # # . ##  #  # #    # # # #    ## # ##  #  #    ### ##  #  #   #   #    #  #  # 
# #  #   #   #   # #   #.# # # ## #  ## #      ## #   ### # # ### #  #   # # #  ### # #  # ## # #   
#   #  # # #  ##  ### #..#     #    #   # # # ## #  #     #  ###   # # #  ##   #      # ## #      # 
  #  #  #   #  ##  # #..#  ## #  # #  # ##  #     # # ## #  # # # # # #  #   #  # # # #   ## ####  #
#  # # # # #  #   # ...#  #  # ###  # #  ##  # # # #   #  # #          #  # #  # #   #  ##      # # 
 ## #  # #  # # #  #.#  ## #       ###  # # #   #  ## ## #   # # ## # # ##  # ##   #  #### # ## #   
      #    #  # # #..# #     # # #  ### #   #### #  #   #  ##   # # ###   ##    ######  #   #   # # 
# # #  # ## #  #  #.#  # ## #   # ## #  # #       # # #  #   # #        #   ## ##  #   # # ## #  #  
  ##  #   #   #  #.. ##  # # # #      ## #  # ## ##    #### #  # # # ##  ###  ## #   #       ###  # 
 # ## # ## # #####.## ##   # #  # # #  #   #    #   # #  # #  # #  # ###    #      ## #### #  ## # #
 #   # # # # ## ... #    ##    # #   #   #  ## #  # #   #    #  ## ## #  ##  ## # #         ##      
# ## #         #.# #  # #   ## #  # #  ##  #   # #  # #  ## # #        #  # ####   # # ## ## ## # # 
      # # ### #E.# # # #  # #   #    #  # # ## #  # # # # # #  # # ## #  ##  ##  # #  #       # #  #
#### # # #     #  # ## ##  #  # # # # # # # # #  #  #  #     #   # ##  #   ##   # ### # ## ###   #  
     # #   # #  ##      # # #  #   #    #     ##  #  # # ###  # #    ##  ##  # ##  # # # # # ### ## 
 # #     ###  # # # # #   #   #  #  # #  # # #   #  #   ##  ## #  # #  #   # ### #             ##   
# # ## ##    # #     #  #  ## # ###  #  #   #### # # # #  #      ##  #   ##      ## # ## # # #   # #
  #    ## # ##  # ##  # # ####   #  # # ## ###    #  #  #   # # ## ## ##   # # #    #   #  #  # #   
# ## ##  ##   #   #  # #   ## # ####   #    #  ##  #   ####  #         ## ###  ## # ## # # # # #  # 
   ## ## #  ##  #  ### # ##      #   #   # #  # # #  #  # ###  # ### #  ## #  #    #   #    ##  # ##
 #         #   #  #       # # # #  #  # #   #   #  #  # #     #    #  #     #  ## #  #  # #    #    
